111111
111P11
111E11
111C11
111111
