1111111111
10C1000001
10P000C001
1E01C00101
1111111111
