111111111111111111111111111111111111111111111
10000000000000000000000P000000000C0000000C001
10000000000010011C0000C00000C000C0001C0000001
10000E0000000C0000000C11100C1000000C000010001
111111111111111111111111111111111111111111111
