11111111
11111111
11000111
1E001P11
11C00101
11100001
1C000001
10000001
1C000001
10000001
1C000001
1C000001
1C000001
1C000001
1C000001
1C000001
1C000001
1C000001
1C000001
1C000001
1C000001
1C000001
1C000001
1C000001
10000001
11111111
