11111111111111111111111111111111111111111111111111111111111111111111111111111111111111
1000000000110101010100000000011000000P00000000C0000000000000000C000000000000E000000001
10000000001100000000000000000000000000000000000000000000000000000000000000000000000111
11111111111111111111111111111111111111111111111111111111111111111111111111111111111111
