1111111111111111111111111111111
1P00000000000000C0000000000C001
1E000000000000000000C000000C001
100000000000000C000000000000001
100000000000000C000000000000001
100000000000000C000000000000001
100000000000000C000000000000001
100000000000000C000000000000001
100000000000000C000000000000001
100000000000000C000000000000001
100000000000000C000000000000001
100000000000000C000000000000001
100000000000000C000000000000001
100000000000000C000000000000001
100000000000000C000000000000001
100000000000000C000000000000001
100000000000000C000000000000001
100000000000000C000000000000001
100000000000000C000000000000001
100000000000000C000000000000001
100000000000000C000000000000001
100000000000000C000000000000001
100000000000000C000000000000001
100000000000000C000000000000001
100000000000000C000000000000001
100000000000000C000000000000001
100000000000000C000000000000001
100000000000000C000000000000001
100000000000000C000000000000001
100000000000000C000000000000001
100000000000000C000000000000001
1111111111111111111111111111111
